zipcode,region,borough,two_months_ago,three_months_ago,num_increase,percent_increase
11209,NYC,Brooklyn,108,2,106,5300
11001,Outside NYC,Outside NYC,28,1,27,2700
11435,NYC,Queens,91,4,87,2175
10017,NYC,Manhattan,31,2,29,1450
11733,Outside NYC,Outside NYC,13,1,12,1200
12204,Outside NYC,Outside NYC,23,4,19,475
12534,Outside NYC,Outside NYC,27,5,22,440
11563,Outside NYC,Outside NYC,44,9,35,389
14127,Outside NYC,Outside NYC,29,6,23,383
14006,Outside NYC,Outside NYC,31,8,23,288
