zipcode,region,borough,two_months_ago,three_months_ago,num_increase,percent_increase
11101,NYC,Queens,12,1,11,1100
11418,NYC,Queens,12,1,11,1100
10075,NYC,Manhattan,11,1,10,1000
11365,NYC,Queens,23,3,20,667
11955,Outside NYC,Outside NYC,27,4,23,575
11953,Outside NYC,Outside NYC,13,2,11,550
11772,Outside NYC,Outside NYC,34,6,28,467
11787,Outside NYC,Outside NYC,5,1,4,400
11429,NYC,Queens,9,2,7,350
10463,NYC,Bronx,34,8,26,325
