zipcode,region,borough,two_months_ago,three_months_ago,num_increase,percent_increase
10001,NYC,Manhattan,108,1,107,10700
11375,NYC,Queens,66,1,65,6500
11385,NYC,Queens,61,3,58,1933
10463,NYC,Bronx,322,24,298,1242
10464,NYC,Bronx,7,1,6,600
12095,Outside NYC,Outside NYC,26,5,21,420
13820,Outside NYC,Outside NYC,10,2,8,400
14219,Outside NYC,Outside NYC,22,5,17,340
11101,NYC,Queens,57,13,44,338
14610,Outside NYC,Outside NYC,17,4,13,325
