zipcode,region,borough,two_months_ago,three_months_ago,num_increase,percent_increase
11209,NYC,Brooklyn,116,2,114,5700
11001,Outside NYC,Outside NYC,30,1,29,2900
11435,NYC,Queens,99,4,95,2375
10017,NYC,Manhattan,32,2,30,1500
11733,Outside NYC,Outside NYC,13,1,12,1200
12204,Outside NYC,Outside NYC,25,4,21,525
12534,Outside NYC,Outside NYC,27,5,22,440
11563,Outside NYC,Outside NYC,47,11,36,327
14006,Outside NYC,Outside NYC,33,8,25,312
14127,Outside NYC,Outside NYC,30,8,22,275
