zipcode,region,borough,two_months_ago,three_months_ago,num_increase,percent_increase
10030,NYC,Manhattan,409,2,407,20350
11203,NYC,Brooklyn,180,1,179,17900
10039,NYC,Manhattan,535,6,529,8817
10002,NYC,Manhattan,200,6,194,3233
10310,NYC,Staten Island,69,5,64,1280
12207,Outside NYC,Outside NYC,38,3,35,1167
14001,Outside NYC,Outside NYC,33,4,29,725
10703,Outside NYC,Outside NYC,101,19,82,432
11754,Outside NYC,Outside NYC,9,2,7,350
11703,Outside NYC,Outside NYC,24,6,18,300
