zipcode,region,borough,two_months_ago,three_months_ago,num_increase,percent_increase
10001,NYC,Manhattan,88,1,87,8700
11375,NYC,Queens,59,1,58,5800
11385,NYC,Queens,53,3,50,1667
10463,NYC,Bronx,293,24,269,1121
10464,NYC,Bronx,6,1,5,500
13820,Outside NYC,Outside NYC,10,2,8,400
12095,Outside NYC,Outside NYC,23,5,18,360
14610,Outside NYC,Outside NYC,17,4,13,325
11702,Outside NYC,Outside NYC,16,4,12,300
14219,Outside NYC,Outside NYC,19,5,14,280
