zipcode,region,borough,two_months_ago,three_months_ago,num_increase,percent_increase
14303,Outside NYC,Outside NYC,20,3,17,567
14301,Outside NYC,Outside NYC,63,10,53,530
10465,NYC,Bronx,10,2,8,400
14305,Outside NYC,Outside NYC,19,4,15,375
14208,Outside NYC,Outside NYC,17,5,12,240
11590,Outside NYC,Outside NYC,18,6,12,200
11758,Outside NYC,Outside NYC,3,1,2,200
11516,Outside NYC,Outside NYC,6,2,4,200
10606,Outside NYC,Outside NYC,3,1,2,200
11411,NYC,Queens,3,1,2,200
