zipcode,region,borough,two_months_ago,three_months_ago,num_increase,percent_increase
10001,NYC,Manhattan,103,1,102,10200
11375,NYC,Queens,65,1,64,6400
11385,NYC,Queens,58,3,55,1833
10463,NYC,Bronx,309,24,285,1188
10464,NYC,Bronx,7,1,6,600
12095,Outside NYC,Outside NYC,25,5,20,400
13820,Outside NYC,Outside NYC,10,2,8,400
11702,Outside NYC,Outside NYC,18,4,14,350
14219,Outside NYC,Outside NYC,22,5,17,340
14610,Outside NYC,Outside NYC,17,4,13,325
