zipcode,region,borough,two_months_ago,three_months_ago,num_increase,percent_increase
10035,NYC,Manhattan,283,1,282,28200
10128,NYC,Manhattan,71,2,69,3450
10463,NYC,Bronx,168,7,161,2300
10039,NYC,Manhattan,162,7,155,2214
10001,NYC,Manhattan,81,5,76,1520
11101,NYC,Queens,55,5,50,1000
10065,NYC,Manhattan,48,5,43,860
10463,NYC,Bronx,168,20,148,740
14850,Outside NYC,Outside NYC,23,3,20,667
11961,Outside NYC,Outside NYC,7,1,6,600
