zipcode,region,borough,two_months_ago,three_months_ago,num_increase,percent_increase
11375,NYC,Queens,118,3,115,3833
11385,NYC,Queens,100,6,94,1567
11211,NYC,Brooklyn,75,5,70,1400
11101,NYC,Queens,77,7,70,1000
10307,NYC,Staten Island,26,4,22,550
11552,Outside NYC,Outside NYC,58,11,47,427
11572,Outside NYC,Outside NYC,20,4,16,400
14203,Outside NYC,Outside NYC,71,15,56,373
10282,NYC,Manhattan,13,3,10,333
11558,Outside NYC,Outside NYC,17,4,13,325
