zipcode,region,borough,two_months_ago,three_months_ago,num_increase,percent_increase
10035,NYC,Manhattan,219,1,218,21800
10128,NYC,Manhattan,58,2,56,2800
10463,NYC,Bronx,143,5,138,2760
10001,NYC,Manhattan,62,3,59,1967
10039,NYC,Manhattan,120,6,114,1900
11101,NYC,Queens,43,4,39,975
10463,NYC,Bronx,143,17,126,741
10065,NYC,Manhattan,36,5,31,620
14850,Outside NYC,Outside NYC,18,3,15,500
11575,Outside NYC,Outside NYC,27,5,22,440
