zipcode,region,borough,two_months_ago,three_months_ago,num_increase,percent_increase
11375,NYC,Queens,104,2,102,5100
11385,NYC,Queens,85,5,80,1600
11101,NYC,Queens,64,4,60,1500
11211,NYC,Brooklyn,50,5,45,900
14203,Outside NYC,Outside NYC,61,12,49,408
10307,NYC,Staten Island,17,4,13,325
11552,Outside NYC,Outside NYC,44,11,33,300
10282,NYC,Manhattan,8,2,6,300
11572,Outside NYC,Outside NYC,15,4,11,275
14850,Outside NYC,Outside NYC,114,33,81,245
