zipcode,region,borough,two_months_ago,three_months_ago,num_increase,percent_increase
10032,NYC,Manhattan,369,1,368,36800
11432,NYC,Queens,245,1,244,24400
10031,NYC,Manhattan,404,2,402,20100
10009,NYC,Manhattan,140,1,139,13900
11101,NYC,Queens,97,1,96,9600
10039,NYC,Manhattan,216,4,212,5300
10035,NYC,Manhattan,328,7,321,4586
11207,NYC,Brooklyn,211,6,205,3417
11109,NYC,Queens,22,1,21,2100
11102,NYC,Queens,45,3,42,1400
