zipcode,region,borough,two_months_ago,three_months_ago,num_increase,percent_increase
10456,NYC,Bronx,544,7,537,7671
11705,Outside NYC,Outside NYC,75,2,73,3650
10461,NYC,Bronx,96,4,92,2300
11755,Outside NYC,Outside NYC,25,2,23,1150
11777,Outside NYC,Outside NYC,12,1,11,1100
11791,Outside NYC,Outside NYC,11,1,10,1000
10603,Outside NYC,Outside NYC,21,2,19,950
14059,Outside NYC,Outside NYC,9,1,8,800
11716,Outside NYC,Outside NYC,115,15,100,667
11021,Outside NYC,Outside NYC,20,3,17,567
